@@@@@@@@@@@@@@@@@@@@@@@@@@@@@@@@@@@@@@@@@@@@@@@@@@@@@@@@@@@@@@@@@@@@@@@@@@@@@@@@@@@@@@@@@@@@@@@@@@@@@@@@@@@@@
@        @@                                      @@                                     @@@                 @
@        @@                                      @@                                     @@@                 @
@        @@                                      @@                                     @@@                 @
@        @@@@@@@@@@@@@@@@          @@@           @@@@@@@@@@@@@@@           @@@          @@@          @@@    @
@        @@                        @@@                                     @@@          @@@          @@@    @
@        @@                        @@@                                     @@@           @@          @@@    @
@        @@                        @@@                                     @@@          @@@          @@@    @ 
@        @@                        @@@                                     @@@          @@@          @@@    @ 
@        @@                        @@@                                     @@@          @@@          @@@    @ 
@        @@           @@@@@@@@@@@@@@@@@@@@@@@@@@@@@@@@@@@@@@@@@@@@@@@@@@@@@@@@          @@@          @@@    @ 
@        @@           @@                         @@                                     @@@          @@@    @ 
@        @@           @@                         @@                                     @@@          @@@    @ 
@        @@           @@                         @@                                     @@@          @@@    @ 
@        @@           @@                         @@                                     @@@          @@@    @ 
@        @@           @@                         @@                                     @@@          @@@    @ 
@        @@           @@           @@@`          @@          @@@@@@@@@@@@@@@@@@@@@@@@@@@@@@@@@@@@@@@@@@@    @ 
@                     @@           @@@                       @@@                                     @@@    @ 
@                     @@           @@@                       @@@                                     @@@    @ 
@                     @@           @@@                       @@@                                     @@@    @ 
@                     @@           @@@                       @@@                                     @@@    @ 
@@@@@@@@@@@@@@@@@@@@@@@@           @@@@@@@@@@@@@@@@@@@@@@@@@@@@@@@@@@@@@@@@@@           @@@                 @ 
@                     @@                                     @@@                        @@@                 @ 
@                     @@                                     @@@                        @@@                 @ 
@                     @@                                     @@@                        @@@                 @ 
@                     @@                                     @@@                        @@@                 @ 
@                     @@                                     @@@                        @@@                 @ 
@        @@@@@@@@@@@@@@@@@@@@@@@@@@@@@@@@@@@@@@@@@           @@@           @@@@@@@@@@@@@@@@@@@@@@@@@@@@@    @ 
@                     @@                                     @@@           @@@                       @@@    @ 
@                     @@                                     @@@           @@@                       @@@    @ 
@                     @@                                     @@@           @@@                       @@@    @ 
@                     @@            ,                        @@@           @@@                       @@@    @ 
@                     @@                                     @@@           @@@                       @@@    @ 
@@@@@@@@@@@           @@           @@@@@@@@@@@@@@@@@@@@@@@@@@@@@           @@@          @@@          @@@@@@@@
@                     @@           @@@           @@                                     @@@                 @ 
@                     @@           @@@           @@                                     @@@                 @ 
@                     @@           @@@           @@                                     @@@                 @ 
@                     @@           @@@           @@                                     @@@                 @ 
@@@@@@@@@@@@@@@@@@@@@@@@@@@@@@@@@@@@@@@@@@@@@@@@@@@@@@@@@@@@@@@@@@@@@@@@@@@@@@@@@@@@@@@@@@@@@@@@@@@@@@@@@@@@@