@@@@@@@@@@@@@@@@@@@@@@@@@@@@@@@@@@@@@@@@@@@@@@@@@@@@@@@@@@@@@@@@@@@@@@@@@@@@@@@@@@@@@@@@@@@@@@@@@@@@@@@@@@@@@@@@@@@@@@@@@@@@@@@@@@@@@@@@@@@@@@@
@      @@             @@                                                          @                                                          @@ 
@      @@             @@                                                          @                                                          @@ 
@      @@             @@                                                          @                                                          @@ 
@      @@             @@              @@@@@@@@@@@@    @@@@@@@@@@@@@@@                           @@@@@@@@@@@@@@                               @@ 
@      @@             @@             @                             @@                           @@                            @@             @@
@      @@             @@             @                             @@                           @@                            @@             @@
@      @@             @@             @                             @@                           @@                            @@             @@
@      @@              @             @              @              @@                           @@                            @@             @@
@      @@                            @              @@@@@@@@@@@@@@@@@@@@@@@@@@@     @@@@@@@@@@@ @@             @@@@@@@@@@@@@@@@@@            @@
@      @@                            @             @@                                           @@             @@                            @@
@      @@                            @             @@                                           @@             @@                            @@
@      @@                            @             @@                                           @@             @@                            @@
@      @@                            @             @@               @                           @@             @@             @@             @@
@      @@                            @@            @@              @@             @@@@@@@@@@@@@ @@             @@             @@             @@
@      @@                                          @@              @@                           @@             @@             @@             @@
@                                                  @@              @@                           @@             @@             @@             @@
@                                                  @@              @@                           @@             @@             @@             @@ 
@                                    @             @                              @             @@             @@                            @@
@                                    @             @@                             @             @@                            @@             @@
@      @@                            @             @@                             @             @@                            @@             @@
@      @@                            @             @@                             @             @@                            @@             @@ 
@      @@                            @             @@                             @             @@                            @@             @@ 
@      @@             @@@@@@@@@@@@@@@              @@@@@@@@@@@@@@@@@              @             @@@@@@@@@@@@@@@      @@@@@@@@@@@@            @@ 
@      @@             @@                                           @              @                                           @@             @@ 
@      @@             @@                                           @@             @                                           @@             @@
@      @@             @                                            @@             @                                           @@             @@
@      @@             @                                            @@             @                                           @@             @@
@      @@             @              @             @@              @@             @                            @@                            @@
@      @@             @              @             @@              @@             @                            @@                            @@
@      @@             @              @             @@              @@             @                            @@                            @@
@      @@             @              @             @@              @@             @                            @@                            @@
@      @@                           @            @@@@@@@@@@@@@@@@@@@            @@@@@@@@@@@@@@@@@            @@@              @@@@@@@@@@@@@@@@@
@      @@                            @                                            @             @@             @@                            @@
@      @@                            @                                            @             @@             @@                            @@ 
@      @@                            @                                            @             @@             @@                            @@
@      @@             @@@@@@@@@@@@@@@@@@@@@@@@@@@@@@@@@@@@@@@@         @@@@@@@@@@@@             @@             @@             @@             @@ 
@      @@                                                                                       @@                            @@             @@ 
@      @@                                                                                       @@                            @@             @@ 
@      @@                                                                                       @@                            @@             @@ 
@@@@@@@@@@@@@@@@@@@@@@@@@@@@@@@@@@@@@@@@@@@@@@@@@@@@@@@@@@@@@@@@@@@@@@@@@@@@@@@@@@@@@@@@@@@@@@@@@@@@@@@@@@@@@@@@@@@@@@@@@@@@@@@@@@@@@@@@@@@@@@@